 ### ######### ########### ### ### ##### 
#   #         #           #   #   #     #
# # # ##### # # ####### # ### # # # ### #
# # #     # # # # #     #   #   #     # #
# ####### # ### # # ####### ##### ##### #
# #     # #   #   #       #     #   #   #
# # # ### ### ### ####### ##### ### # ## 
# # #     #     #       # #   # #   #   #
# # ####### ### ####### # ### # ####### #
# # # #     #   #   #   #   #   #     # #
# # # # ##### ##### # ## ## # ### ### # #
# # # #     #       #   # # #   # #     #
# # # ##### ### ####### # # ### # ##### #
# #   #   #   # #     # # # #   #   # # #
# ### ### ### ### # ### # # ### ### # # #
#   #       #     #       #   #     # # #
# # ####### ######### ####### ####### # #
# #   #     #       #   #     #     #   #
# ### # ##### ##### ##### #### ## # # ## 
# #   #   #   #   #   #   #   #   # #   #
# ### # ### ### # ### # ### # # #### ## #
#   # # #   #   #   # #     # # #   #   #
# # ### # ### ### ########### # # # # ## 
# #     # # #   #             #   # #   #
# ####### # # ####### ######### ### ### #
#   #   # #   #   #   # #   #   #   #   #
 ## # # # # ### # # ### # # # ### # # ## 
#   # # # #   # # # #   # # # #   # #   #
# ### ### ##### # # # # # # # # ####### #
#   #   #   #   #   # # # # # #       # #
 ## ### ### # ######### # # # ####### # #
# #     # # # #   #   #   # # #   #   # #
# ##### # # # # # # # ##### # # # # ### #
# #   #   # #   #   #     # # # # #   # #
# # # ### # # ########### # # # # ### # #
# # #     # # #           # # # # #x#   #
# # ####### ### ########### # # # # #### 
# # #     #   # # #         # # # #     #
# # ### # ### # # # # ####### # # ##### #
#       #   #   #   #           #       #
 ####### ### ### ### ########### ####### 